#S#############################################################
#     #               #   #           #                       #
### ### # ### ####### # # # # # ####### ### # ############### #
#       #   # # #   # # #   # #       # #   #             #   #
# ######### # # # # # # # ### ####### ### ######### ##### # ###
#   #   #   #   # #   # #   #       #     #       #   #   #   #
# # ### # ### ### # ### # # ##### # ### ### ##### ### # # ### #
# #     #   # #   #   # # #     # #   #   # #     #   # # #   #
# ######### # # ####### # ##### ##### ### # # ##### ### # # # #
# #       # # #         #     #   # #   # # # #   # #   # # # #
# # ##### # # ########### ### # # # # # ### # # ### # ##### ###
# #     # # #       #   #   # # # # # #   # # # #   #     #   #
# ##### # # # ##### ### # # # # # # # ### ### # # ### ### ### #
# #   # # # #     #     # # # # #   #   #     # #   # #   #   #
# # # # # # # # # ####### # # ##### ########### # # ### ### # #
#   #   # # # # # #     # # #     #   #       # # #   # #   # #
# ######### # # # # ### ### # ### # ### # # # # # ### # # #####
# #     #   # # #   # # #   # #   # #   # # #   #   # # #     #
# # ### # # # ####### # # ##### ##### # # ######### # # ##### #
# # # #   # #       # # #   #   #     # #       # # # #     # #
# # # # ##### ##### # # # # # ### ##### ### ### # # # ####### #
# #   # #   # #   # #   # # #     #   #   #   # # # # #     # #
# ####### # ### ### # ##### # ##### # # # ##### # # # # ### # #
#   #     #   #     # #     #   #   # # #     #   # # #   #   #
# # ######### ### ### # ######### ### ####### # ### # ### #####
# #   #     #   #   # #       #   #   #       # #   #   # #   #
##### # ### ### ##### ####### # ### ### ####### # ####### # ###
#   #   # #   # #   #       #   #   #   #     # #     #   #   #
# # ##### # # # # # ### # # ##### ####### ### # ##### # ##### #
# #       # # #   #   # # #     # #     # #   #   #   #       #
# # ##### # # # ##### # ####### # # # # ### # ### # ###########
# #     # # # # #   # # #     # #   # #   # #   # # #   #     #
# # ### ### # ### # # ### # # # ######### # ### # # # # # ### #
# #   # #   #     #   #   # # #       #   # #   # #   # # #   #
# # # # # ############# ##### ####### # ### # ### # ### # ### #
# # # # #               #   # # #     # #   #   # #   # #   # #
# # # # ################# # # # # ##### # # ### # ##### # # ###
# # # #                 # #   # #     #   # #   #   #   # #   #
# ### ############# ### # ##### # ### ####### ##### # ### ### #
#   #       #     #   # #     # #   #       #   #   #   #   # #
# # # ##### ### # ### # # ### # # # ####### ### # ##### # ### #
# # #     #   # # # # # # #   # # #       #   # #   #   # #   #
### # ### # # ### # # # # # ### ##### ### # # ### # # ##### # #
#   #   # # #     #   # # # #   #   # #   # #   # # #   #   # #
# ### # # ############# ### # ### # ### ### ### # # ### # ### #
#   # # #   #   #     #   # #   # #   # #   #   # # # #   #   #
### # # ### ### # ### ### # ### # # # # ##### # # # # ####### #
#   # #   #     # #   # # #   # # # # #   #   # # #   #     # #
# ### # # ####### # ### # ### # # ### # # # ##### ##### # # ###
# #   # #         #     #   #   # #   # # #     #   #   # #   #
# # ################### ### ####### # ### # # # # # # ### ### #
# #           #       #   # #       # #   # # # # # #   # # # #
# ### ####### ####### # # # # ####### # ### # # # # ### # # # #
#   #   #   #         # # #   #   #   #   # # # # #   # #   # #
# # ### # # ############# ####### ####### # ### # ### # # ### #
# #   #   # #           #         #   #   # #   #   #   # #   #
##### # ### # # ####### # ######### # # ##### ##### ####### # #
#     #   #   #   #   # # #       # # #     #   #   #       # #
# ####### # ####### # # # # ##### # ####### # # ##### #########
# #       #   #   # #   # #   #   #         # #     # #       #
# ############# # ########### # ################### # # ##### #
#               #             #                     #   #     #
#############################################################E#
