#############################################################
S       #             #   # #   #         #   # # #         #
### ####### # ### # # # ### ### ### ##### # ### # ### # # # #
#   #     # # # # # # #     #     #     #       #     # # # #
# # # ##### ### ### ### ### # ##### ### ####### # ### ##### #
# # #           #       #             #   # #   #   # #   # #
# # ### ##### # # # ##### ################# # ### ### ### # #
# #   # #     # # # # #                   #     # #   # # # #
# # ### ### ### ### # # ### ##### ##### ##### # # ##### # # #
# # # #   # #     # #     # #     #         # #     # #   # #
# ### ### ### ### ### ### ######### ### ######### ### # ### #
#     # #   #   #   # #       # #     # # #   #     #       #
# # # # ### ### ### ########### ####### # ### # ### ##### ###
# # #       # #   #   # # #   # #     #   #     #   #       #
######### ### ######### # # ### ### ### # ### ### ##### ### #
#     #       #     #   #     # #       # #   # # # #   # # #
##### # ########### # # ### ### # ### ### ##### ### ### # # #
E   #     # #         # # #   #     # #   #   #     #   #   #
# ### ### # # ##### ##### # ####### ######### # ### # ### ###
#     #       #       #                   #       #   #     #
#############################################################
