################################################################S####################################
#   #   #           #   # #   #   # #       #     # #       # #   #             # #     #     #   # #
# ### ### # # ##### ### # # # # ### # # ### ##### # ##### ### # ### # ######### # ##### # # # # ### #
#     #   # # #           # #   #   # # # # #         # #   #   #   # #     #       #     # #     # #
##### # ########### ##### ##### ### # # # # # # # ##### # ##### # # ####### # ##### # ####### # ### #
#     # #               # #       #   # #     # #   #     # #   # #   # # #   # #   #   #     #     #
# ### # ############### ##### # ### ##### ### ##### # ### # ### ##### # # ### # # # ### ### # ##### #
# #           # # # #     #   #   # #   #   # #   # #   # #   # #   # #   #     # #     # # # # #   #
# ### ##### ### # # ######### ##### # ########### # # ##### # # ### ### # ### ##### # ### ### # #####
#   #   #   #     # # # #     #     #     #             # # #           #     # #   #       #     # #
##### # ##### ##### # # ### ##### # # # ### # ##### ### # ##### ### # # # ##### ### ### ####### # # #
# #   #     #     #   # #         # # #     # #   # #   #       #   # # #   # # # #   # #   #   #   #
# ### # ####### ### # # ### ### # # ######### # ####### ### ### # ### ##### # # # ### ### ### # ### #
# # # # #   # #   # # # #   #   # #   # # #           # #     # #   # # #   # #       # #   # # # # #
# # # # ### # ### # ### ### ### ####### # # # ####### # # ########### # ##### # # ##### # ####### # #
#     #     # # #           #     #     #   # #     # #   # #     #   # #     # # # #       # #     #
##### ### ### # ### ##### # # ### # ##### ##### ### ####### ##### # ### ### ##### # # # # ### ##### #
#   #   #           #   # # # #   #     #   # #   #     #         # #     #   # #     # #   #   # # #
# # # ####### ### ### ### ### ##### # ### ### ### ### ##### ### ### # ### # ### # ##### ##### ### # #
# #         #   #   #     #         #   #   #     #         #         #     #       #     #         #
###############E#####################################################################################
