#S#####################################################################################################
# #   #     #                         #                   #       #   #               #               #
# # # # ### # # ################### # ### # ##### # ##### # # # ### ### # # ####### # # ### # ####### #
# # #   #   # #   #         #     # #     #     # # #   #   # #   # #   # # #   #   #   #   # #     # #
# # # ### ### # # # ####### # ### ####### ##### # ### # # ### ### # # ##### # # # ####### # # # # # # #
#   #   #     # # #   #   # #   #   #   #   #   #     # #   # #   #   #     # #   #       # # # # # # #
# ##### ######### ### ### # ### ### # # ##### ######### ##### # # ##### # ### ############### # ### # #
#   # #         #     #   #     #   # #     #   #     # #   # # # #   # #   #   #           # #   #   #
# # # ####### # ####### # ####### ######### # # # # ### # # ### ### # # # # ### ########### # ### #####
# # # #     # #         #     # #           # # # # #   # #   #   # # # # #   #   #         # # #     #
# # # ##### ### ############# # # ########### # # # # ####### ### # # # ##### ### # # ####### # # ### #
# #   #   #   #             #   #     #     # #   # #         #   # #   #   #   #   #       #   #   # #
# ##### # ### ################# ##### ##### # ##### # ######### ### # ### # ### # ##### ### ####### # #
#       #   #       #         #     #       # #   # # #       #     # #   #     #     #   # #     # # #
# ######### ##### # # # ##### # ### ######### ### # ### # ### ######### ####### ##### ### # ##### # # #
#       # #     # #   #   #   #   #     #     #   #     #   #         #   #   #   #   # # #     #   # #
# ##### # # ### ########### # ### # ### # # ### ########### # ####### ### ### ### # ### # ##### # ### #
#     #   #   # #           #   # #   # # # #   #           #       #   #     # # # #   #     # # #   #
##### ##### ### # ############### ##### # ### ######### ########### ### # ##### # # # ####### # # # ###
#     #   # #   # #       #     #     # #   #         #   #   #     #   # #     # # #   #     # # #   #
# ##### # # # # # # ##### # # # ### # # ### ######### ### # ### ##### ##### ##### # ### # ##### # ### #
#       # # # # # # #   # # # #   # # #   # #   #     #   #     #     #   #       #   #   #     #   # #
# # ##### ### ### # # # # # ### # # # ### # # # # # # # ##### ### ####### ### ####### ### # ### ##### #
# # #   #   # #   # # #   #   # # # #   # #   # # # # # #   # #   #     #   # #     #   # #   # #   # #
# ### # ### # # ### # # ##### ### # ### # # ### # # ### ### # # ### # # ### ### ### ### ##### ### # # #
# #   #   # # # #   # #     #   # # #   # #   #   #   #   # # # #   # #   #     #   #   #   #   # #   #
# # ##### # # # # ### # ##### # # ### ### # # ####### # # # # # # # # ### # ##### # # ### ##### # ### #
# #     #   #   # #   # #   # # #   # #   # #   #   # # #   # #   # #   # # #     # #     #   # #   # #
# ##### ######### ####### # # # ### # # ##### # # # # ### ####### # # # # ### ####### ##### # # ### # #
#     # #       #     #   # # #   #   #     # # # # #   # #     # # # # # #   #     #     # #   #   # #
##### # # ##### ### # # ### # ### # ####### # # # # ### ### ### # # ### # # ### # # ##### # # ### ### #
#     #   #   #   # #   #   # #   # #   #   # #   # #   #   #   # #   # #   #   # # #     # # #   # # #
# ######### # ### ####### ### # ##### # # ### ####### ### # # # # ### # ########### # ##### ### ### # #
#           #   #       # #   #     # # #   # #   #   #   # # # # # # #           # # #   #   #   # # #
# ############# ####### # # ####### # # ### # # # # ######### # # # # ########### # # # # # # ### # # #
#         #   #   #   #   #       #   #   # #   # #     #     # #   #         # #   # # # # #   # # # #
# ####### # ### # # # ############# ####### # ### ##### # # ### ############# # ### # # # ####### # # #
#   #     #   # #   # #   #       #     #   #   # #   # # #   #     #       # #   # # # #         # # #
### # ####### # ##### # ### ##### # ### # ####### # # # # ### ##### # ####### ### # # # ########### # #
#   #         #     # #     #     # #   #       #   # # # #   #   #   #       #   # # #   #       # # #
# ####### ######### # # ##### # ### # ######### ##### # # # ### # ##### ####### ### # ### # ### # # # #
#   #   #   #     # # # #     #   # #       # # #     # # #   # #     # #     #   # # #   #   # # #   #
### # # ### # ### # # ### ##### ### ####### # # ##### # # # # # ####### # ### ### # # # ##### # # #####
#   # # #   # #   # #   #     # #   #     #   #     # # # # # #       # #   #   # # # #       # #     #
# ##### # ### # ### ### ##### ### # ##### # ####### # # # # # ####### # ### # # # # # # ############# #
#     # #     #   #   #       #   # #   # # #   #   # # # # # #       #     # #   # # # #   #   #   # #
# ### # ######### ### # # ##### ##### # # ### # # ### # # # # # # ########### ##### # ### # # # # # # #
# #   #   #   #   #   # #     #     # #   #   # #   # #   # #   #           # #     #   # # # # # # # #
# # ##### # ### ### # # ### ####### # # ### ##### # # ############# # ##### # # ####### # ### ### # # #
# #       #   # #   # #   # #     #   #   #     # # #     #       # #   # # # #     #   #   #   # #   #
# ########### # # ####### ### # # ##### # # ### # # ##### # ##### # ### # # # ##### # ##### # # # # ###
# #           # # #   #   #   # #     # # # #   # #   #   # #   # #   # # # #     # # #     # #   #   #
# # # ######### # # # # ### # # ### # ### ### ####### # ##### # # # # # # # ##### # # # # ### #########
#   #         # # # # #   # # #   # #   #   #       # #       #   # # #   #   #   # #   #   #   #     #
# ########### # # ### # ### # ### # ### ### ####### # ############# # ######### ### ##### # ### ##### #
#     #       # #   # # #   # #   # #   #   #     # # #           # #       #   #   #   # #   #   #   #
# ### # ####### # # # ### ### # ##### ####### ##### # # ##### ### ######### # ### ##### ####### # # # #
# #   # #       # #   #   # # # #   #   #   # #   #   #     # # #   #       # #   #   #       # #   # #
### ### # ####### ##### ### # # # # ### # # # # # ######### # # # # # ####### # # ### # ##### # # #####
#   #   #       #   # # #   # # # #   # # # #   # #         # # # # #   #   # # # #   #     # # # #   #
# ### # ####### ### # # # # # # # # # # # # ##### # ### ##### # # # ### # # # # ### ####### # # ### # #
#   # #     # #   #   # # # # # # # # #   #       #   #     #   # #   # # #   #     #   #   # #   # # #
##### # ### # # # ### # # ### # # # # ### ########### # ### ##### ### # # ############# # ### # # # # #
#     # #   # # #   # # #     #   # #   # #       #   #   #   # # #   # #     #       #   #   # #   # #
# ####### # # # ### ### ### ##### # ### ### # ### # ##### ### # # # ### ##### # ##### ##### ### # ### #
#       # # # #   #   #   # #   # # # #   # #   # # #   # #   # # # # #     #   #   #       #   #   # #
# ##### # ### # # ### # # ### # ### # ### # ### # # ### # # ### # # # # # # ####### ######### ##### # #
#     # #   # # # #   # # #   #   #   #   # #   # #   # # #     # # # # # #       #     #   #     # # #
# ### # ### # # # # ##### # # ### # ### ### # ### # # # # # ##### # # # ####### # ##### # # # ### # # #
#   # #   #   # # #     #   # #   # #   #   # #   # # #   # #   # #   #   #   # #     # # # # #   # # #
# ### ### # ### # ##### ####### # # # ### ### # ##### ####### # # # ##### # # ####### # # # # # ##### #
# #   #   #   # # #   #       # # # #     #   #     #       # #   #   # #   # #     #   # # # #     # #
### ### # ##### # ### # ##### # # # ####### ####### # ##### # # ##### # ##### # # # ##### # ####### # #
#   # # # #     #   # #     #   # # #     # #     # # #     # # #   #   #     # # #       #   #     # #
# ### # ### ##### # # ##### # ### # # ### # # ### # ### # ### # # # ### # ##### # ########### # ##### #
#     #   # #   # #   #     #   # #   # # #   # # #     # #   # # #   # # #     #         #   #   #   #
# # ##### ### # # ##### ####### # ##### # ##### # ### ### # ##### # # # # # # ############# ##### # ###
# # #   #   # # #     #       # # #   # #   #   #   #   # # #     # # # #   #           #   #   # #   #
# ### # ### # # ##### # ##### ### # # # ### # ##### ### # # ######### # ################# ### # # ### #
#     #   # # # #     #     #   #   #   # # #   #   #   # #           #   #         #   # #   # #   # #
# ####### # ### # ######### ### # ####### # ### # ### # # ##### ######### # # # ### # # # # # # ### # #
#   #   # #     #   #   #   #   # #     # #     # #   # #     #     #   # # # # #   # # #   # #   # # #
# # # # # ######### # ### ### ##### # # # # ##### # ##### ### # ##### # ### # ### # # ### ### ##### # #
# #   # #   #   # # # #   #   #     # #   # #     #     #   # # #   # #     # #   # #   #   # #     # #
# ##### ### # # # # # # # # ### ##### # ### # # ####### ### # ### # # ######### ####### ### # # ##### #
#     #   # # #   # # # # # #   # #   # #   # #     #   #   #     # #     #     #   #   #   # # #   # #
# # # ### # # # ### # # # # # ### # # ### ### # ### # ######### ### ##### # ##### # # # ##### # ### # #
# # # #   # # # #   #   # #   # #   # #   #   #   # #     #   # #   #     #       #   # #     #   # # #
# # # # # # # # # # ##### ##### # ##### ### ####### # ### # # ### ### # ############### # # ##### # # #
# # # # # #   # # #     #       #   #   #   #       # #   # #   #   # #     #       #   # #     #   # #
# ### # ####### # ##### ####### # ### ### # ######### # ### # # ### # # ### # # ### # ### ##### ##### #
# #   #     #   #     # #     # # #   #   # #   #   # #     # #   # # #   # # #   # # # # #   # #     #
# # ####### ### ##### # # ### # ### ### ##### # # # # ########### # # ### # # ### # # # # # # # # #####
# #       #   # #   # # # #   #   #   #       #   # # #     #   # #   #   #   #   # #   # # #   # #   #
# ####### ### ### # # ### # # ### ### ############# # # # # # # # ############# ### ##### # ##### # # #
#   #   #   #   # # #   # # #   #   #       #   #   #   # # # #   # #     #     #   #   # #     #   # #
# # # ######### # ##### ### # # ### ####### # # # ######### # # ### # # # ####### ### # # # # # ##### #
# #   #   #   # #     #     # #   #       #   # # #       # # # # #   # #   #   # #   #   # # #     # #
# ##### # # # # ##### # ##### ### ####### ##### # ####### ### # # # ####### # # # # ####### ######### #
#     # # # # #   #   #     #   #       #     # #         #   #   # #     # # # # #     # #       #   #
##### # ### # ### # ########################### # ######### ######### ### # # # ####### # ####### # ###
#     #     #     #                             #         #           #   #   #         #         #   #
#####################################################################################################E#
