#S#############################################################################################################################################
#       #           #   #           #   #               #             #           #   #       #       #                                       #
### ### # # ####### # ### ### # ### ### ### # # # ### # # ##### ##### # # # ##### ### # ##### # # ### # # ##### # ######################### ###
# #   #   # #   #   #     #   #   #   #   # # # #   # #   #   #   #   # # #     #     #     # # #   #   #     # #   #       #         #   #   #
# # # ####### # # ######### # ### # # ### # # ##### # ####### # ### ### # ### ############# # # ### # ####### # ### # # ### # # ##### # # ### #
# # #     #   # # #         # #   # #   # # #   #   #       # # #   #   #   # #   #     #   #   #   #   #   # #   #   #   # # # #   #   #   # #
# ####### # # # # # # ####### # ####### # # ### # # ### ### # # # ### ##### ### # # ### # ##### # ##### # # # # # ####### # # # # # # ####### #
#       #   # # #   #       # #       #   #   # # #   #   #   # #     #   # #   # # #   #     # #   # # # #   # #   #   # #   #   # # #   #   #
# ##### # ##### # ######### # ####### # ##### # # ### ######### # ##### # # # ### # # ####### ##### # # # ####### # # # ########### # ### # # #
# #     # #     # #       # #   #     # # #   # #   #       #   #     # #   #   #   #       # #     #   #       # #   # #     #   # #     # # #
# # ####### # ### # ##### # ### # ##### # # ####### ####### # ######### ####### ########### # # ### ####### ### ####### # ### # # # # ##### ###
# #         #   #   #   # #   # #     #   # #     # #   #   #       #   #       #       #   # #   # #     #   #   #   #   # # # #   #     #   #
# ############### ### # ##### # # ### ##### # ### # # # ##### ##### # ### ####### # ##### # # # # # # ### ### ### # # # ### # # ######### # # #
#           #   # #   #       # #   #     # #   #   # #     #     # #     #     # #   #   # # # # # # #   #   # # # # #   #   #     #     # # #
# ########### # ### # # ####### # # ##### # ############### # ### # ####### # # # ### # ### # # # ### # ### ### # # # ### ####### # ##### # # #
# #       #   #   # # # #       # #   #   #     #           #   # #       # # #   #   #   # # # #     #   #     # # #   #   #   # #     # # # #
# # # ### # ##### # # ### ########### # ####### # # ######### # # ####### # # ##### ##### # # # ######### # ##### # ### # ### # # ##### # # # #
#   #   # # #   #   #   #     #   #   #       # # #     #   # # # #     #   #   # #     # # # # #     #   #   #   # #   # #   # #   #   # # # #
# ##### # # ### # ##### ##### # # ########### # # ##### # # ### # # ### ####### # # ### # ### # # ##### # # # # ##### ##### ### ##### ##### # #
# #     # #     #   # #     #   #     #     #   # #   # # # #   # #   #       #   #   # # #   #   #     # # # #     #     # #   #     #   # # #
# # ##### ######### # # # # ######### # # # # ### # # # # # # # # ### ####### ####### # # # # # ### ### # ### ##### ##### # # ### ##### # # # #
# # #   # #   #   #   # # #         # # # # # #   # # # # #   # #   # #     #       # # # # # #   #   # #   #     # #   #   #   #   #   # # # #
# # ### # # # ### # ### ########### # # # # ### ### # # # ####### # # # ### ####### ### # # # ####### # ### ##### # # # ####### # # ##### ### #
# #     # # # #   #   # #     #   # # # # #     # # #   #       # #   #   #       #   # #   # #       #   #   #   #   #   #   # # #     #   # #
# ####### # # # # ### # # ##### # # # # # ####### # ########### ######### ####### # # ### ### # ######### ##### ######### # # # # ##### ### # #
#   # #   # # # #   # # # #     # # #   #         # #         #         #     # # # #   # #   #   #     #   #   #     #   # #   #     #     # #
# # # # ### # # # # # # # # # ### # ##### ######### # ########### ##### ##### # # # ### ### ##### ##### ##### ####### # ### # ####### ### ### #
# #   #   # #   # # # # #   #   #   #   #   #     # #           #     #   #   #   #   #   # #   # #     #   # #     # #     #   #   #   # #   #
# ####### # # ##### # # ####### ####### # ### # # # ########### ##### ### # # ######### # # # # # # # ### # # # ### # # ######### # ### ### ###
#       #   #   #   # #     #   #       # #   # # #     #     # #   #   #   # #   #   # # # # #   # #   # #   # #   # #   #       #   #   #   #
# ##### ######### ### ##### ##### ##### ### ### # ##### # ### # # ### # ####### ### # # # ### ##### ##### ##### # ### ### # ######### ### # # #
#   # #       #   #   #   # #     #   # #   #   #     #   # #   #   # # #     #   # # # #   #     # #   #       #   #   # #         #     # # #
### # # # ### # ### ### # # # ##### # ### # # ##### # ##### ####### # # # # # ### # # ##### # ### # # # ##### ##### ### # ### ############# # #
#   # # #   # #   #     # # # #     #   # # #     # #       #       # #   # #   # # #   #   # # # #   #     #   #   #   #   #     #       # # #
# ### # ##### ### ######### # # # ##### # # ##### ########### # ##### # ### ### # # ### # # # # # ######### # # # ### ##### ####### ##### ### #
#     # #   # # #       #   # # #     #   #     #   #       # # #   # #   #   #   #   #   # #   #   #       # # #     #   # #       #   #     #
# ##### # # # # # ##### # ### # ### # ######### ### # ##### # # # ### # # ### # ##### ######### ### # # ##### # ####### # # # ### ##### # #####
# #     # # #   # # #   #     #   # # #       #   # # #   # # # #     # # #   # #   #     #   # # # # #   #   #         # # #   # #   # #     #
# # ####### # # # # # ########### # # # ### # ### # # # # # # # ######### # ##### # ##### # # # # # # # # # ########### ### ### ### # # # ### #
# #       # # # # # #             # # #   # #   # #   # # #   #   #     # #       # # #   # # #   #   # # #       #   # #   # #     #   # #   #
# ####### # # ### # ############### # ### # ### # ##### # ######### ### # ######### # # ##### # ####### # ####### ### ### ### # ######### # # #
#   #   #   # #   #   #         # # #   # # #   #       # #       # #   # #       #   #       #     # # #       #   #   #     #         # # # #
### # # # ### # ##### # ### ### # # ### # # # # ######### # ##### # # ### # ### # ############### # # # ####### # # ### ##### ####### # # # ###
#   # # # #   #   #   #   # #   # #   #   # # # #   #     #     #   #   # #   # #           #   # #   # #     # # #     #   #       # # # #   #
# ##### # # ##### # ##### # # ### # # ####### # # # # # ####### # ##### ##### # ########### ### # ##### # ### # ########### ####### ### # ### #
#       # #   #   # #     # #     # #   #     # # #   # #     # # #   # #   # #     #   # #     #     #   # # #           #     #   #   # # # #
# ####### ### # ### # ##### # ##### ##### # ##### ####### ### # # # # # # # # ##### # # # # ######### ##### # ########### # ### ##### # # # # #
#   #   # # # #   # # #     #     #   #   # #   #         #   # # # #   # #   # #   # #   #         #       # #       # # # #   #     # #   # #
# # # # # # # ### # # # ### ##### ### # ##### # ########### ### # # ##### # ### # ### # # ######### ##### ### ####### # # ### # # ### # ##### #
# #   # #   # #   # # #   # # #   # # #     # #     #       #   # # #     # #   # #   # #         #     #   #   #   # # #     # #   # # # #   #
# ##### # ### # ### # # # # # # ### # ##### # ##### # ####### # # # # ####### # # # # # ##### ### ##### # # # # # # # # # ######### # # # # # #
# #     #   # #     # # # # # #   # #     #   #   # # #     # # # #   #   #   # #   # #     #   # #   # # # # #   #   # #   #       # #   # # #
# # ####### # ####### # # # # ### # # ### ####### # # ##### # # # ##### # # # # ########### # # # # # # ### ### ####### # # # ####### ##### # #
# #       # #     #   # # # #   #   #   # #   #   # # #     # # #     # # # # #       #     # # #   # #   #   #     # # # # # #     # # #   # #
# ####### ####### # ##### # ### ####### # ### # ### # # ##### # ##### # # # # ####### # ####### ##### # # ### # ### # # # # # # ### # # # #####
# #     #   #   #   #   # #     #     # #   # # #   # #   #   # #   #   #   # #     # # #     #     # # # # # #   #   # # # # #   # #   #     #
# # ### ### # # ##### # # ####### # # # ### # # # # # ### # # # # ### ##### # # ### # # # ### # ##### # # # # ##### ### ### # ### # ######### #
#   # # #   # #     # # # #     # # # #   #   # # # #     # # # #   #     # # # # # # #   # # # #     # # #   #   # #   #   # #   #         # #
# ### # # ### # ### # # # # ### # ### # # ##### # ######### # # ### ##### # # # # # # ##### # # # ####### # ### # ### ### # # # # ######### # #
# # #   #   # #   #   # #   #   #   # # #     # #           # #     #     # #   #   #   # #   # #       # # #   #   # #   # #   #   #     # # #
# # # ##### # ### ### # ##### ##### # ####### # # ########### # ##### ################# # # ### ####### # ### ##### # # ### ######### ### # # #
#   #     # #   #   # # #     #   # # #     # # #     #   #   #     #         #     #   # # #   #     # #   # #   #   # #   #       # #   # # #
# ####### # ### ### # # # # ##### # # # # # ### ##### # # # ##### # ######### # # ### ### # # ### # # # ### # # ##### # ##### ##### # # ### # #
# #     # #     #   # # # # #     # #   # #     #   #   # # #   # #         #   # #   #   # #     # # #   # # #     # #       #     # #     # #
# # ##### ####### ##### # ### ##### # ### ####### # ##### # # # ########### # ### # ### ### ######### ### # # ##### # ######### ##### # ##### #
# #     #       # #   # # #   #     #   #         #     # #   #   #     #   # #   #     # #     #     #   #   #     #     #   # #     #     # #
# ##### # ##### # ### # # # ### ####### # ############### # ##### # ##### ### # ######### # ### # ##### ####### # ####### # # # # ######### # #
#     # # #   # #     # #   #   #   #   # #     #         #     # #       #   #           #   # #   #   #       # #     #   # # #         # # #
# # # # # # # # ####### ##### # # ### # # ##### # ############### ######### # ##### ######### # ##### ### # ### # # # ####### # # ####### ### #
# # # # #   # #       #   #   # #     # #   #   #             #   #   # #   # #   # #   #   # #   #   #   #   # #   # #     # # #     #   #   #
# ### # ################# # ### ########### # ####### ####### # ### # # # # # ### # # ### # # # # # ### ##### # # ##### ### # # # ### # ### ###
#   # #   #   #   #       # #   #   #   #   #       # #       #   # # #   # #     #   #   #   # # #     #     # # #   #   #   # #   # # #   # #
### # ### # # # # # ####### # ### # # # # # ####### # # ######### ### ##### ######### # ######### ######### ### ### # ### ##### # ### # # ### #
#   #   #   # # # #     #   #   # # # # # # #     # # #     #   #   # #   #   #     # # #   #     #       #   #     #   #   #   # #   # #     #
# ##### ##### # # # # # # ##### # # # # # ### ### # # ### # # ##### # # # # # # ### ### # # # ##### ##### # # ############### ##### ### #######
# #     #   # # # # # #   # #   # #   # #   #   #   #   # #   #     #   # # # #   #   # # #   #   # #     # # #   #   #     #     # #   #     #
# # ##### # # # # # ####### # ### # ### ### ### # ### # # ##### ######### # # ### ### # # ##### # # ####### # ### # # # # # ##### # # ####### #
# #     # #   # # #         # #   # # #   #     #   # # #     #   #       # #   #   #   #   #   # #   #   # #     # #   # #   #   # #         #
# ##### # # ##### # ######### # # # # ### ##### ### # # # ### ### # # ######### ########### # ### ### # # # ####### # # # ### # ###############
#     #   # #     #         # # # #   # # #   # #   # # #   #   #   #   #       #         # #   #   #   # #   #   # # # #   # #     #         #
# ### ####### # ####### ### # # # ##### # ### # # ##### # # ### ####### # ####### ####### # ### ### ##### # # # # # # ##### # ### # # ####### #
#   #     #   #       #   # #   # #     #     # #   #   # #   #       # #       #   #     #   # #   #     # #   # # # #   # #   # # # #   #   #
### ##### # # ####### ### # ####### ########### ### # ########### ### ######### ### # ####### # # ### # ########### # # # # ### ### # # # # ###
#   #   #   #       #   # #       # #         #   # # #   #     #   # #       #   # #     #   # # #   # #         # #   # #   #     # # # #   #
# ### # # ######### # # ######### # # # ##### ##### # # # # ### ### # # # ### ### # ##### # ### # # ##### # ##### # # ### # # ####### # ##### #
#     # #       # # # #       # # # # #     #   #   # # # # # # # # #   #   # #   # #   #   #   #   #     #   # #   #   # # #         #     # #
# ##### ####### # # ######### # # # # ##### ### # ### ### # # # # # # # ### # # ### # # ##### # ##### ####### # ######### ################# # #
# #   # #     # # #         #   #   # #   #   # #   #     #   # #   # #   # # #   #   #       # #   #       #   #       #     #             # #
# # ### # ### # # # ####### ######### # ##### # ### ########### # ### # ### # # # ########### # # # # # ### ##### ##### # # # # ############# #
# #     # #   # # #   #   #         # #   #   # # # #         # # #   # #   # # #       #   # #   # # # #   #     #   # # # #   #     #     # #
# ####### # ### # ##### ##### ##### # # # # # # # # # # ##### # # # # ### ### ######### ### ### # # # ### ### ##### # # # ####### ### # # ### #
#     #   #   #   #   #     #     # # # #   # # # #   # #   # # # # # #   # #         #   #   # # # #   #   # #     #   # #       #   # # #   #
# ### # ##### ##### # ##### ##### # # # ####### # ####### # # # ### ### ### ####### # # # ### # # # ### ### # # # ####### # # ##### ### # # ###
#   #   #   #       #     # #   # #   #     #   # #     # # # #   #   #     #     # # # #   # # # # #   #   # # #       #   #     #     # # # #
# # ##### # ############# # ### # # ####### # ### # ### # # # ### # # ########### # # ##### # # ### # ### ##### # ##### ##### ### ####### # # #
# # #     # #     #     # # #   # # #     # #     #   #   # #     # # #           # #   #   # #   # #   #     # #   # # #   #   #       # #   #
# # # # ### # ### # ##### # # ### # # # ### ######### # ### ######### # # ### ##### ### # ### ### # ### ### # # # # # # ### ### ####### # #####
# # # # # #   #   #     #   #     #   # #   #     #   #   #       #   # #   # #   #   # #   # #   #   #   # # # # #   #   #   #     #   #     #
# # # # # ##### ####### ##### ######### # ### ### # # ### ####### # ### ### # # # ### # ### # ####### ### # # # ##### ### ### ##### # ####### #
# # # #   #     #     #     #     # #   #   # # #   # #   #     # #     #   # # #   # # #   #     #   #   # #   #   #   #   #     # #       # #
### # ##### ##### # # ##### # # # # # # ### # # # ### # ### ### # ############# # # ### # ##### # ######### ##### # ### # # ##### # ####### # #
#   #     #       # #       # # #   # # #   # # #   # #     # # #         #     # #   # # #   # #   #     #     # # #   # #       #       # # #
# ####### # ####### ######### ####### ### ### # # # # ####### # ####### # # ##### # # # # # # ##### # ### ##### # # ##### # ############# # # #
#         #     #   #     #   #   # #   # #   # # # #         # #     # # # #     # # # #   #       # #   #   # # #   #   #   #   #     # # # #
# ### ######### # ### ### # ### # # # # # # ### # # ########### # ### ### # ####### # # ####### ####### ### # # # ### # ### ### # # ##### # # #
#   #       # # #     # # #   # # # # # #   #   # # #         #   # #   # #     #   #   #     # #   #   # # #   # # # #   # #   #   #     # # #
### ### ### # # ####### # ##### # # # # ##### ##### # # ##### ##### # # # ##### ### ##### # # ### # # ### # # ### # # ### ### # # ### ##### # #
# #   #   #   #         #   #   #   # #       #     # #     #       # # #     #   #   #   # #   # # #   #   #   # # #   #     # #   #     # # #
# ### ##### ### ########### # ####### ##### ### ##### # ### # ######### ##### ### ##### # # ### # # # # # ##### # # ### # ##### # # # ##### # #
# #   #   #   #       #     # #   #   #   #   # #     # #   #     #   # #   #   #     # # # # #   # # # #   #   #   #   #   #   # # # #     # #
# # ### # ### # ##### # ##### # # # ##### ### # # ####### ####### # # # # ##### # ### # # # # # ### ### ### # ####### # ### # ##### ### ##### #
# #     # #   #     # #     # # # #     #   # # # #     # #   # # # #   #   #   #   #   # #   #   # #   #   # #       #   # # #   #   #     # #
# # ##### # ######### ##### # # # ##### # # ### # # ### # # # # # # ####### # ##### ############# # # ####### # # ####### # # # # ### ####### #
# #     # #       #   #     # # #     # # #   #   #   #   # # #   #         #     # #       #   # # # #       # #     #   # #   #   # #   #   #
# ##### # # ##### # ### ##### # # ### # ##### ####### ####### ### ##### # ####### ### # ### # # # # # # ####### ####### # # ####### ### ### # #
# #     # #     # # #   #     # #   # #       #   #   #     #   #     # #   #   #   # # #   # #   #   # #       #   #   # #   #   #   # #   # #
# ####### # ### # ### ### ##### # # # ######### # # ### ### ### ##### # ##### # # # # # # ### ########### ####### # # ##### # # # ### # # #####
#   #     #   # #   #     #     # # #           # #     # #     # #   #   #   # # #   # #   # #     #   #         # #     # #   # # # # #     #
# # # ####### # ### ####### # ### # ############# ####### # ##### # # ### # ### # ##### ### # # ### # # ########### ##### # ##### # # # # ### #
# #   #       # # #   #     #   # #   #       # #       # #     #   #   # # #   # #   # #   # # # # # #         #   #     #     #   #   #   # #
# ##### ####### # ### # ####### # ### # ##### # # ##### # ##### # ##### # ### # # ### # # ##### # # # # ####### # ### ### ####### ######### # #
#     #     #   # # #   #     # #   #   #   #   # #     #   # # # #     #     # #   # # #       # #   #       #   # #   #   #   # #     # # # #
# ### ##### # ### # ##### ### # ### ##### ### ### # ####### # # # # # ############# # # # ##### # # ######### ##### # # ##### # # # # # # # # #
# #   #   # #     # #   #   # #   #     #   #   # # #       #   # # # #     #     #   # #     # # #       # #       # #   #   # #   # # # # # #
# # ### # # ####### # # ### ##### # ### ### ##### # # ############# ### ##### # # ##### ##### ### # ##### # # ##### # ### # # # ##### # # # # #
# #   # #   #       # #   #   #   #   #   #   #   #   #     #     #   #   #   # #     # #   # #   #     # # #     # # # #   # #   #   #   # # #
# ### # ##### ####### ### # # # # ### ### ### # ####### ### # ### # # ### # # # ##### # # ### # # ####### # ### # # # # ##### ### # ####### # #
#   # #       #       #   # #   #   #   #     #   #     #   # #   # #   #   # #     #   #     # # #       #   # # # # # #   # #   #       # # #
# # # ############# ### ##### ##### ### ######### # ##### ### # ### ### ####### ############### # # ######### ### ### # # ### # # ####### # # #
# # # #           # #   #   #     #   # #       #   #   # #   #   # #   #     # #   #         # # #         #   #   #   #     # # #     # # # #
### # # ######### ### # ### # ### ##### # ##### # ### # # # # ### ### ### # # ### # # # ##### # # ######### ### # # # ######### # # ##### # # #
#   #   #       #   # # #   # #   #     # #   # #   # #   # #   #     #   # # #   #   #   #   # #         #     # # #   #       #   #     # # #
# # ##### # ### ### # # # # # # ### ##### # ### # # # ##### ### ####### ### # # ######### # ### # ####### ####### # ##### ######### # # ### # #
# #   #   #   #   #   # # # # # #   #     # #   # # #     #   #   #     #   # #         # # #   #   #   #       # # #     #   #   # # # #   # #
# # ### ##### ### ##### # ### # # ### ##### # ##### # ##### # ##### # ### ### ######### # # # # ### # ######### # # # ##### # # # ### ### ### #
# # #   #     #   #     #   # # #   # #     # #     # #   # # #     #   # # #   #       # #   #   # #           # # # #   # # # #     #   #   #
# ### ### ##### ########### # # ### # # ### # # ##### # # ### # ####### # # ##### # ##### ######### # ############# # # # # # ### ##### ### # #
#   # #   #     #           # # #   # #   # # #     # # #     #     #   #   # #   #   #   #   #   # # #           # # # # # #   # #     #   # #
# # # # ### ##### ########### # # ### # # ### # ### # # ########### # ####### # ####### ### # # # # # # ######### ### # # # # # ### ##### #####
# # # # #   #     #         # # # #   # #     #   # # #         #   #         #   #   #   # # # #   # #     #   #     # # # # #   # #   #     #
# # # # # ### ##### # ##### ### # # ############### # ######### # # ############# # # ##### # ############### # ####### # # # ### ### # ##### #
# #   # #     #     #     #     #   #               #         #   #             #   #       #                 #         #   #   #     #       #
#############################################################################################################################################E#
