#S#########################################
#           #   #   #                     #
### # ##### # # # # # # ##### ### # # ### #
# # #   #   # # # #   # #   # #   # # # # #
# # # # # ##### # # ### # # ### ### # # # #
#   # # #       # # #   # #   # #   #   # #
# ### # ######### # # ### ### # # ####### #
#   # #           # # #   # #   #   #   # #
# # # ####### ####### # ### ##### # # # # #
# # #       #   #   # #     #   # #   # # #
### ####### ##### # # ####### # ####### ###
#   #   #   #   # #   #   #   #   #   #   #
# ### # # ### # # ####### # ##### # # # # #
#     # #     # #       # #   #   # # # # #
# ### # # ##### ####### # ### ##### # # # #
#   # # #     #     #   #   #       # # # #
# # ### ########### # ##### ######### # # #
# #   #   #       # #     #         # # # #
# ### ### # ##### # ##### # ####### # ### #
#   # #   # #     #   #   # #       #   # #
### # # ##### # ##### # ##### # ####### # #
# # # #   #   #   #   #       #     #   # #
# # # ### # ##### # ########### ### # ### #
# # #   #   #   # #       #   #   # #   # #
# # ### ####### # # # ### ### # # # ### # #
# # #   #     #   # #   #     # # #   #   #
# # # ####### # ### ### ######### ### #####
# # #       # #   #   #   #     # #   #   #
# # # ##### # ####### # ### ### # # ### # #
#   #     # #   #     # #   #   # #     # #
# ####### # ### # ##### # ### ### # ##### #
#   #   # #   # #   #   #   # #   #   # # #
# # # # # ### # # # # ##### ### # ### # # #
# #   # #   #   # # # #   # #   #   #   # #
####### ### ####### # # # # # ##### # ### #
#     # #   #     # # # # #   #     #   # #
# ### # # ### ### # ### # ############# # #
# #   # #     #   # #   #   #     #   # # #
### ######### # ### # # ##### # # # # # # #
#   #   #   # #   #   #   #   # #   # # # #
# ### # # # ############### # # ##### ### #
#     #   #                 # #     #     #
#########################################E#
