#S###################
# #       #     #   #
# ### ####### ##### #
#   #         #     #
# # # ##### # ##### #
# # #     # # # #   #
# # # ####### # # # #
# #     # #     # # #
##### ### ### ##### #
#           #       #
################# # #
#     #   #       # #
# ##### # # # #######
# #   # #   #   #   #
# # ####### # # ### #
#   #     # # #     #
# ##### ####### #####
#   #           # # #
### # ### ### ### # #
#       #   #       #
###################E#
