#S#########
#         #
### # ### #
#   #   # #
# # # # # #
# # # # # #
# ### # ###
# #   # # #
# # ### # #
# #   #   #
#########E#
