#S###########################################################
# # #         #   # #       #   # #   #     # #     # #     #
# # ##### ##### ### ### ### # ### ### # ### # ### ### ### ###
#       #   #   #         # #         #   #   #       #     #
### ##### ### # ### ##### # ####### # ### # # ### # # ##### #
#           # #   #     # # # #   # # #   # #     # # # #   #
# # ##### # ### ### ##### ### # ### # # ########### ### # ###
# #   # # #     # # #       # #   # #     #     #   #       #
# ### # ### ### # # ### ### # # # ### ### # # # ### ##### # #
# #     #   #         #   #     #     #   # # #           # #
###########################################################E#
